##########
#   X   O#
##    ####
#P     XO#
#   X    #
###   ####
#        #
#O     ###
##########
